video,frame,case,tp,fp,fn,tn,iou,dice,gt_area,pred_area
LapChol Case 0001 03,0,TP,28689,0,91062,880249,0.2395721121326753,0.38654001616814876,119751,28689
LapChol Case 0001 03,102,TN,0,30003,53912,916085,0.0,0.0,53912,30003
LapChol Case 0001 03,470,TN,0,26000,18768,955232,0.0,0.0,18768,26000
LapChol Case 0001 03,497,TP,0,18871,10507,970622,0.0,0.0,10507,18871
LapChol Case 0001 03,634,TN,0,19046,39032,941922,0.0,0.0,39032,19046
LapChol Case 0001 03,659,TP,13299,18701,9711,958289,0.318836757689818,0.48351208871114343,23010,32000
LapChol Case 0001 03,808,TP,136,13436,28844,957584,0.003206337231233497,0.006392178981011468,28980,13572
LapChol Case 0001 03,3121,TP,0,18683,46492,934825,0.0,0.0,46492,18683
LapChol Case 0001 03,3205,TP,11826,0,17387,970787,0.40481977201930647,0.5763298325982602,29213,11826
LapChol Case 0001 03,3401,TP,10935,0,22154,966911,0.33047236241651307,0.4967744866436489,33089,10935
LapChol Case 0001 03,4150,TP,26522,178,40888,932412,0.3924069361425105,0.5636382956115185,67410,26700
LapChol Case 0001 03,4554,TN,6993,5855,14931,972221,0.2517369235753627,0.40222017715403197,21924,12848
LapChol Case 0001 03,5026,TP,10788,2790,26178,960244,0.2713552671294899,0.42687559354226023,36966,13578
LapChol Case 0001 03,5157,TP,11500,250,31340,956910,0.2668832675794848,0.421322586554314,42840,11750
LapChol Case 0001 03,5432,TN,7590,15791,9305,967314,0.2322095086581411,0.37689939418015694,16895,23381
LapChol Case 0001 03,5489,TP,0,11826,44103,944071,0.0,0.0,44103,11826
LapChol Case 0001 03,5516,TN,13206,372,23034,963388,0.36070140937397577,0.5301698181380224,36240,13578
LapChol Case 0001 03,5548,TP,10200,15604,22419,951777,0.21151732575741866,0.3491775499375246,32619,25804
LapChol Case 0001 03,6055,TP,7946,17796,45404,928854,0.11168582914007814,0.20093056187730743,53350,25742
LapChol Case 0001 03,6212,TN,0,13500,39176,947324,0.0,0.0,39176,13500
LapChol Case 0001 03,6516,TP,16554,14786,47906,920754,0.2088938242939707,0.34559498956158663,64460,31340
LapChol Case 0001 03,7051,TP,10125,0,20619,969256,0.32933255269320844,0.49548557586434705,30744,10125
LapChol Case 0001 03,7384,TP,0,15334,44772,939894,0.0,0.0,44772,15334
LapChol Case 0001 03,7902,TP,0,14418,32400,953182,0.0,0.0,32400,14418
LapChol Case 0001 03,8679,TP,5024,23472,11439,960065,0.1258044322023288,0.22349251540292267,16463,28496
LapChol Case 0001 03,8785,TP,0,35750,37584,926666,0.0,0.0,37584,35750
LapChol Case 0001 03,8850,TP,13578,33293,9238,943891,0.2419932631128696,0.3896853071591545,22816,46871
LapChol Case 0001 03,9545,TP,11016,17926,64935,906123,0.11734503659043216,0.2100426148551381,75951,28942
LapChol Case 0001 04,0,TP,37570,33061,0,929369,0.5319194121561354,0.6944482953022615,37570,70631
LapChol Case 0001 04,3,TP,12684,61097,12162,914057,0.14758619084742214,0.2572115140884342,24846,73781
LapChol Case 0001 04,188,TP,12862,10322,0,976816,0.5547791580400276,0.7136436775231648,12862,23184
LapChol Case 0001 04,300,TP,6912,63103,5292,924693,0.09178429628055824,0.16813631885573893,12204,70015
LapChol Case 0001 04,1273,TP,0,11972,3139,984889,0.0,0.0,3139,11972
LapChol Case 0001 04,1491,TN,5264,5671,94,988971,0.47728715205367667,0.6461670656109986,5358,10935
LapChol Case 0001 04,1727,TP,0,9750,5642,984608,0.0,0.0,5642,9750
LapChol Case 0001 04,1815,TP,0,18543,4897,976560,0.0,0.0,4897,18543
LapChol Case 0001 04,3621,TN,0,12784,5859,981357,0.0,0.0,5859,12784
LapChol Case 0001 04,6013,TN,330,7935,7502,984233,0.02092979006786326,0.04100142883767162,7832,8265
LapChol Case 0001 04,6329,TP,7488,2637,5874,984001,0.4680292518282393,0.6376293268616682,13362,10125
LapChol Case 0001 04,6382,TN,6633,2763,1782,988822,0.5933977455716586,0.7448206164729662,8415,9396
LapChol Case 0001 04,7240,TP,6363,606,2757,990274,0.6542257865515114,0.7909752004475107,9120,6969
LapChol Case 0001 04,7543,TP,6800,46385,100,946715,0.12761565168433894,0.2263460098194225,6900,53185
LapChol Case 0001 04,7664,TP,6240,42960,96,950704,0.12658227848101267,0.2247191011235955,6336,49200
LapChol Case 0001 04,7747,TN,11808,4543,3600,980049,0.5918500325798206,0.7436002393022451,15408,16351
LapChol Case 0001 04,7774,TP,5643,2907,513,990937,0.6226415094339622,0.7674418604651163,6156,8550
LapChol Case 0001 04,7823,TN,14651,8707,1771,974871,0.5830315571650284,0.7366013071895425,16422,23358
LapChol Case 0001 04,7848,TP,0,40250,5124,954626,0.0,0.0,5124,40250
LapChol Case 0001 04,7911,TP,0,40391,4503,955106,0.0,0.0,4503,40391
LapChol Case 0001 04,8013,TP,5696,3679,0,990625,0.6075733333333333,0.7558887930462478,5696,9375
LapChol Case 0001 04,8088,TN,6201,9497,0,984302,0.395018473690916,0.566327229553861,6201,15698
LapChol Case 0001 04,8140,TP,5162,4213,0,990625,0.5506133333333333,0.7101877966568068,5162,9375
LapChol Case 0001 04,8304,TN,0,36150,10318,953532,0.0,0.0,10318,36150
LapChol Case 0001 04,8334,TP,0,40750,5695,953555,0.0,0.0,5695,40750
LapChol Case 0001 04,8499,TP,25450,28849,69,945632,0.46810623896409653,0.6377007692500438,25519,54299
LapChol Case 0001 04,8567,TN,9963,1053,3894,985090,0.6682092555331992,0.8011096369557351,13857,11016
LapChol Case 0001 04,8654,TP,0,36624,6175,957201,0.0,0.0,6175,36624
LapChol Case 0001 04,8750,TP,6272,39080,2392,952256,0.13136729222520108,0.23222748815165878,8664,45352
LapChol Case 0001 04,8839,TP,6075,45550,5583,942792,0.1061914417563977,0.1919946905172005,11658,51625
LapChol Case 0001 04,8862,TN,0,44426,9120,946454,0.0,0.0,9120,44426
LapChol Case 0001 04,8877,TP,0,45250,10956,943794,0.0,0.0,10956,45250
LapChol Case 0001 04,8921,TP,6912,42363,1620,949105,0.13580901856763924,0.23914058851004202,8532,49275
LapChol Case 0001 04,9016,TP,0,40075,7992,951933,0.0,0.0,7992,40075
LapChol Case 0001 04,9144,TP,8468,38459,232,952841,0.1795627557836256,0.30445646898089057,8700,46927
LapChol Case 0001 04,9175,TP,5664,6162,96,988078,0.4750880724710619,0.6441487546912317,5760,11826
LapChol Case 0001 04,9190,TN,26112,20948,2176,950764,0.5303436509870826,0.6931039974518235,28288,47060
LapChol Case 0001 04,9220,TP,0,7866,17952,974182,0.0,0.0,17952,7866
LapChol Case 0001 04,9375,TN,10744,6256,3621,979379,0.5210222588623248,0.6850948509485095,14365,17000
LapChol Case 0001 04,9670,TP,7504,4322,7940,980234,0.3796418091672569,0.5503483681701503,15444,11826
LapChol Case 0001 04,9708,TP,8250,32261,1210,958279,0.19774214424390596,0.3301915110764243,9460,40511
LapChol Case 0001 04,9738,TP,0,8004,15478,976518,0.0,0.0,15478,8004
LapChol Case 0001 04,9746,TN,0,7245,11424,981331,0.0,0.0,11424,7245
LapChol Case 0001 04,9761,TP,12317,16031,226,971426,0.4310562049415553,0.602430852754885,12543,28348
LapChol Case 0001 04,9796,TN,0,23504,5733,970763,0.0,0.0,5733,23504
LapChol Case 0001 04,9801,TP,42,24710,8499,966749,0.0012631199061682355,0.002523052894001742,8541,24752
LapChol Case 0001 04,9828,TN,0,8625,12702,978673,0.0,0.0,12702,8625
LapChol Case 0001 04,9852,TP,12816,19313,432,967439,0.3935997051687602,0.5648676642351852,13248,32129
LapChol Case 0001 04,9886,TP,4814,20631,0,974555,0.1891923757123207,0.31818632472983244,4814,25445
LapChol Case 0001 04,10029,TN,7581,6837,26334,959248,0.18602767962308597,0.31369871516355285,33915,14418
LapChol Case 0001 05,164,TP,0,17869,4895,977236,0.0,0.0,4895,17869
LapChol Case 0001 05,317,TN,0,20988,15219,963793,0.0,0.0,15219,20988
LapChol Case 0001 05,347,TP,5368,7416,792,986424,0.3954036535061874,0.566722972972973,6160,12784
LapChol Case 0001 05,402,TP,4980,37394,83,957543,0.11729514567680241,0.2099626873537534,5063,42374
LapChol Case 0001 05,484,TP,19488,10839,1762,967911,0.6073109165134469,0.7556856738468697,21250,30327
LapChol Case 0001 05,555,TN,0,9375,11616,979009,0.0,0.0,11616,9375
LapChol Case 0001 05,583,TP,812,6318,18253,974617,0.031989914509711226,0.06199656422981485,19065,7130
LapChol Case 0001 05,620,TP,4400,5725,0,989875,0.4345679012345679,0.6058519793459552,4400,10125
LapChol Case 0001 05,644,TN,4070,5305,296,990329,0.4208458277323958,0.5923877447056255,4366,9375
LapChol Case 0001 05,657,TP,3160,34848,869,961123,0.0812819919232451,0.15034374479625093,4029,38008
LapChol Case 0001 05,691,TP,4674,6342,0,988984,0.42429193899782136,0.595793499043977,4674,11016
LapChol Case 0001 05,886,TP,0,14664,39780,945556,0.0,0.0,39780,14664
LapChol Case 0001 05,927,TN,0,29516,6018,964466,0.0,0.0,6018,29516
LapChol Case 0001 05,940,TP,0,29172,45500,925328,0.0,0.0,45500,29172
LapChol Case 0001 05,1040,TP,0,18656,7098,974246,0.0,0.0,7098,18656
LapChol Case 0001 05,1183,TN,130,16570,14882,968418,0.004116268760686467,0.008198789101917256,15012,16700
LapChol Case 0001 05,1195,TP,413,12304,12106,975177,0.016637795592797003,0.03273101917895071,12519,12717
LapChol Case 0001 05,1347,TP,0,32700,11070,956230,0.0,0.0,11070,32700
LapChol Case 0001 05,1469,TP,3200,42898,1616,952286,0.06706626985790334,0.12570216443414384,4816,46098
LapChol Case 0001 05,1532,TP,5440,3185,400,990975,0.602770083102493,0.7521603871413758,5840,8625
LapChol Case 0001 05,1677,TP,7475,35683,115,956727,0.17274050793797519,0.29459289036021125,7590,43158
LapChol Case 0001 05,1800,TP,0,45552,9944,944504,0.0,0.0,9944,45552
LapChol Case 0001 05,1839,TP,60,13467,24160,962313,0.0015920609228646484,0.0031790605875963653,24220,13527
LapChol Case 0001 05,1895,TP,99,15432,10307,974162,0.003831565910674201,0.007633882098932027,10406,15531
LapChol Case 0001 05,2447,TP,6461,10239,182,983118,0.38271531809027365,0.5535706635822302,6643,16700
LapChol Case 0001 05,2708,TN,10101,16024,0,973875,0.38664114832535884,0.557665764920223,10101,26125
LapChol Case 0001 05,2823,TP,12125,5875,2875,979125,0.5808383233532934,0.7348484848484849,15000,18000
LapChol Case 0001 05,2946,TN,0,13659,9261,977080,0.0,0.0,9261,13659
LapChol Case 0001 05,3001,TP,10857,1991,6755,980397,0.5538437994184564,0.7128693368351937,17612,12848
LapChol Case 0001 05,3180,TP,0,11865,19440,968695,0.0,0.0,19440,11865
LapChol Case 0001 05,3316,TP,0,38870,4950,956180,0.0,0.0,4950,38870
LapChol Case 0001 05,3701,TP,0,8625,15276,976099,0.0,0.0,15276,8625
LapChol Case 0001 05,4119,TP,0,8568,13440,977992,0.0,0.0,13440,8568
LapChol Case 0001 05,4389,TP,3045,10527,15159,971269,0.10598308447321708,0.19165407854984895,18204,13572
LapChol Case 0001 05,4806,TP,4752,3873,14044,977331,0.2096254797300278,0.34659567484774445,18796,8625
LapChol Case 0001 05,5185,TN,6556,9048,4994,979402,0.31828332847849305,0.4828754511305885,11550,15604
LapChol Case 0001 05,5484,TP,6720,7722,14736,970822,0.2303105079169237,0.374394116663881,21456,14442
LapChol Case 0001 05,5562,TP,3400,15539,16322,964739,0.09642381100933042,0.1758878456325496,19722,18939
LapChol Case 0001 05,5674,TN,3952,15870,22118,958060,0.09422985216976633,0.17223045410964874,26070,19822
LapChol Case 0001 05,5804,TN,0,12852,5166,981982,0.0,0.0,5166,12852
LapChol Case 0001 05,6676,TP,4029,12613,0,983358,0.24209830549212835,0.3898214890426201,4029,16642
LapChol Case 0001 05,6687,TN,0,14664,11832,973504,0.0,0.0,11832,14664
LapChol Case 0001 05,6724,TP,0,7245,21948,970807,0.0,0.0,21948,7245
LapChol Case 0001 05,6795,TP,0,16600,7632,975768,0.0,0.0,7632,16600
LapChol Case 0001 05,6873,TP,0,17700,15087,967213,0.0,0.0,15087,17700
LapChol Case 0001 05,6963,TN,0,13527,10716,975757,0.0,0.0,10716,13527
LapChol Case 0001 05,7160,TP,10125,5940,7389,976546,0.43169608595548736,0.6030554811042615,17514,16065
LapChol Case 0001 05,7518,TP,10512,2336,16496,970656,0.35823336968375136,0.5274989963869932,27008,12848
LapChol Case 0001 05,7569,TP,0,17596,8019,974385,0.0,0.0,8019,17596
LapChol Case 0001 05,7629,TP,7290,2025,24885,965800,0.2131578947368421,0.351409978308026,32175,9315
LapChol Case 0001 05,7727,TP,9856,2992,0,987152,0.7671232876712328,0.8682170542635659,9856,12848
LapChol Case 0001 05,7879,TP,5022,32192,744,962042,0.1323041256125191,0.23369008841321545,5766,37214
LapChol Case 0001 05,8334,TP,11919,3624,1914,982543,0.6827633614023028,0.8114787581699346,13833,15543
LapChol Case 0001 05,8477,TP,7488,8112,0,984400,0.48,0.6486486486486487,7488,15600
LapChol Case 0001 05,8640,TP,6545,64919,0,928536,0.09158457405127057,0.16780115114922636,6545,71464
LapChol Case 0001 05,8679,TN,5916,2709,1218,990157,0.6010362694300518,0.7508090614886731,7134,8625
LapChol Case 0001 05,8801,TP,9266,2479,164,988091,0.7780670081451003,0.8751829988193625,9430,11745
LapChol Case 0001 05,8974,TP,6322,3053,9658,980967,0.3321599327483844,0.4986787615854861,15980,9375
LapChol Case 0001 05,9021,TP,0,29999,25972,944029,0.0,0.0,25972,29999
LapChol Case 0001 05,9083,TN,17721,4463,15561,962255,0.469492648032852,0.6389860455053546,33282,22184
LapChol Case 0001 05,9295,TP,19539,4749,4815,970897,0.6713740851458613,0.8033797952386826,24354,24288
LapChol Case 0001 05,9359,TP,128,13531,9220,977121,0.005594650115826741,0.011127048289650976,9348,13659
LapChol Case 0001 05,9412,TP,11096,2431,9880,976593,0.4740462254881018,0.6431904472074892,20976,13527
LapChol Case 0001 05,9516,TN,16940,3520,10672,968868,0.5441346524476423,0.7047761690797137,27612,20460
LapChol Case 0001 05,9545,TP,12118,1460,14862,971560,0.4260900140646976,0.5975639824448937,26980,13578
LapChol Case 0001 05,9815,TP,0,37037,10235,952728,0.0,0.0,10235,37037
LapChol Case 0002 02,27,TP,1825,41434,34465,922276,0.023480520817250786,0.04588366918503061,36290,43259
LapChol Case 0002 02,4866,TP,5900,3475,23804,966821,0.17782332198077097,0.3019524552828885,29704,9375
LapChol Case 0002 02,5254,TN,10773,24867,11115,953245,0.2304138594802695,0.37453066332916146,21888,35640
LapChol Case 0002 02,5347,TP,12400,2200,14936,970464,0.4198266522210184,0.5913773368943152,27336,14600
LapChol Case 0002 02,5787,TP,27750,3515,28795,939940,0.46203796203796205,0.6320464639562692,56545,31265
LapChol Case 0002 02,6737,TP,1200,27504,16220,955076,0.026711779894933667,0.05203364842598213,17420,28704
LapChol Case 0002 02,6821,TP,1869,28227,21440,948464,0.036265911207699474,0.06999344630652561,23309,30096
LapChol Case 0002 02,7036,TP,0,26986,12495,960519,0.0,0.0,12495,26986
LapChol Case 0002 02,7346,TP,0,21063,23532,955405,0.0,0.0,23532,21063
LapChol Case 0002 02,8315,TP,5394,1158,2418,991030,0.6013377926421405,0.7510442773600668,7812,6552
LapChol Case 0002 02,9379,TP,0,20944,11349,967707,0.0,0.0,11349,20944
LapChol Case 0002 02,9642,TP,0,16544,15561,967895,0.0,0.0,15561,16544
LapChol Case 0002 02,9848,TP,0,14696,12648,972656,0.0,0.0,12648,14696
LapChol Case 0002 02,9971,TP,0,14696,12750,972554,0.0,0.0,12750,14696
LapChol Case 0002 03,180,TP,0,12717,10057,977226,0.0,0.0,10057,12717
LapChol Case 0002 03,415,TP,0,27072,14300,958628,0.0,0.0,14300,27072
LapChol Case 0002 03,594,TP,0,20826,9588,969586,0.0,0.0,9588,20826
LapChol Case 0002 03,769,TP,0,12616,11875,975509,0.0,0.0,11875,12616
LapChol Case 0002 03,1179,TP,0,11000,3575,985425,0.0,0.0,3575,11000
LapChol Case 0002 03,2096,TN,0,16016,8036,975948,0.0,0.0,8036,16016
LapChol Case 0002 03,2134,TP,0,10854,10296,978850,0.0,0.0,10296,10854
LapChol Case 0002 03,2420,TP,0,8625,5460,985915,0.0,0.0,5460,8625
LapChol Case 0002 03,2532,TP,0,9375,6230,984395,0.0,0.0,6230,9375
LapChol Case 0002 03,6213,TP,0,40075,8648,951277,0.0,0.0,8648,40075
LapChol Case 0002 03,6684,TP,0,57750,6716,935534,0.0,0.0,6716,57750
LapChol Case 0002 03,6802,TN,0,35568,8343,956089,0.0,0.0,8343,35568
LapChol Case 0002 03,6878,TP,0,51500,6192,942308,0.0,0.0,6192,51500
LapChol Case 0002 03,7003,TN,0,54014,5986,940000,0.0,0.0,5986,54014
LapChol Case 0002 03,7023,TP,0,56940,4970,938090,0.0,0.0,4970,56940
LapChol Case 0002 03,7221,TP,0,58500,8370,933130,0.0,0.0,8370,58500
LapChol Case 0002 03,7390,TN,0,52250,11872,935878,0.0,0.0,11872,52250
LapChol Case 0002 03,7443,TP,6642,58026,0,935332,0.10270922249025793,0.1862852334875894,6642,64668
LapChol Case 0002 03,7620,TP,0,43600,5530,950870,0.0,0.0,5530,43600
LapChol Case 0002 03,7657,TN,0,47276,4104,948620,0.0,0.0,4104,47276
LapChol Case 0002 03,7941,TP,21222,14869,51774,912135,0.24152961930233882,0.3890839421745946,72996,36091
LapChol Case 0002 03,8398,TP,0,51750,6776,941474,0.0,0.0,6776,51750
LapChol Case 0002 03,8636,TP,0,37440,8480,954080,0.0,0.0,8480,37440
LapChol Case 0002 03,8826,TN,0,48807,10981,940212,0.0,0.0,10981,48807
LapChol Case 0002 03,8846,TP,0,46750,9180,944070,0.0,0.0,9180,46750
LapChol Case 0002 03,9557,TP,0,29744,10791,959465,0.0,0.0,10791,29744
LapChol Case 0002 03,9810,TP,0,17600,4575,977825,0.0,0.0,4575,17600
LapChol Case 0002 03,9931,TP,0,18700,5166,976134,0.0,0.0,5166,18700
LapChol Case 0007 01,0,TP,0,7068,27416,965516,0.0,0.0,27416,7068
LapChol Case 0007 01,20,TP,0,12555,10350,977095,0.0,0.0,10350,12555
LapChol Case 0007 01,1091,TP,6726,5100,38702,949472,0.13311431285623812,0.23495301638313482,45428,11826
LapChol Case 0007 01,1271,TP,120,29746,4080,966054,0.003535026218111118,0.0070451476545529265,4200,29866
LapChol Case 0007 01,1704,TP,1440,16032,3285,979243,0.06937418702124584,0.12974726314366805,4725,17472
LapChol Case 0007 01,1988,TP,0,20875,7980,971145,0.0,0.0,7980,20875
LapChol Case 0007 01,3006,TP,5544,2322,672,991462,0.6493323963457485,0.7873881550916063,6216,7866
LapChol Case 0007 01,3185,TN,6300,2400,1260,990040,0.6325301204819277,0.7749077490774908,7560,8700
LapChol Case 0007 01,3199,TP,4828,5297,994,988881,0.4342117096861228,0.6055057377563178,5822,10125
LapChol Case 0007 01,3317,TP,4824,3042,576,991558,0.5714285714285714,0.7272727272727273,5400,7866
LapChol Case 0007 01,3419,TP,5005,2795,231,991969,0.6232100610135725,0.7678735808530224,5236,7800
LapChol Case 0007 01,3590,TP,0,11000,6825,982175,0.0,0.0,6825,11000
LapChol Case 0007 01,3689,TP,4599,15553,730,979118,0.22023752514126999,0.36097484400141283,5329,20152
LapChol Case 0007 01,3756,TN,3621,14427,923,981029,0.19087027568393863,0.3205559490084986,4544,18048
LapChol Case 0007 01,3845,TP,5332,1844,3182,989642,0.5147711913496814,0.6796685787125558,8514,7176
LapChol Case 0007 01,3918,TN,3720,4215,992,991073,0.41671334154811246,0.5882818059618882,4712,7935
LapChol Case 0007 01,3932,TP,4736,1750,1339,992175,0.6052396166134185,0.7540800891648755,6075,6486
LapChol Case 0007 01,4069,TP,6834,1716,1512,989938,0.6791890280262374,0.8089488636363636,8346,8550
LapChol Case 0007 01,4223,TN,0,9396,4615,985989,0.0,0.0,4615,9396
LapChol Case 0007 01,4242,TP,0,10875,6160,982965,0.0,0.0,6160,10875
LapChol Case 0007 01,4580,TP,6090,14010,261,979639,0.2991012229261824,0.4604740841556085,6351,20100
LapChol Case 0007 01,4756,TN,0,10904,6882,982214,0.0,0.0,6882,10904
LapChol Case 0007 01,4938,TP,5544,16025,252,978179,0.25406718298886394,0.4051891101772337,5796,21569
LapChol Case 0007 01,5142,TP,6885,1857,255,991003,0.7652550850283428,0.8670192670948244,7140,8742
LapChol Case 0007 01,5511,TP,0,12596,7857,979547,0.0,0.0,7857,12596
LapChol Case 0007 01,6166,TP,7392,2688,2268,987652,0.5986394557823129,0.7489361702127659,9660,10080
LapChol Case 0007 01,6565,TP,11088,1412,1904,985596,0.7697861705081922,0.8699199748940845,12992,12500
LapChol Case 0007 01,6816,TP,0,49234,6720,944046,0.0,0.0,6720,49234
LapChol Case 0007 01,7035,TP,11400,60000,6540,922060,0.1462663587374904,0.2552048354600403,17940,71400
LapChol Case 0007 01,7266,TN,0,57600,15860,926540,0.0,0.0,15860,57600
LapChol Case 0007 01,7315,TP,0,42300,11752,945948,0.0,0.0,11752,42300
LapChol Case 0007 01,7468,TN,0,39400,5700,954900,0.0,0.0,5700,39400
LapChol Case 0007 01,7520,TP,0,29050,5625,965325,0.0,0.0,5625,29050
LapChol Case 0007 01,7729,TP,3538,5432,610,990420,0.36931106471816283,0.5394114956548254,4148,8970
LapChol Case 0007 01,8047,TN,0,41600,15694,942706,0.0,0.0,15694,41600
LapChol Case 0007 01,8101,TP,0,42728,12543,944729,0.0,0.0,12543,42728
LapChol Case 0007 01,8342,TN,0,58000,48024,893976,0.0,0.0,48024,58000
LapChol Case 0007 01,8373,TP,10450,13799,2750,973001,0.38705137227304715,0.5580923389142567,13200,24249
LapChol Case 0007 01,9541,TN,10058,2726,8695,978521,0.4682713347921225,0.6378539493293591,18753,12784
LapChol Case 0007 01,9684,TP,8500,6870,1100,983530,0.5160898603521554,0.6808169803764518,9600,15370
LapChol Case 0007 01,9929,TN,5950,7680,680,985690,0.41579315164220826,0.5873642645607108,6630,13630
LapChol Case 0007 02,129,TP,0,46860,10324,942816,0.0,0.0,10324,46860
LapChol Case 0007 02,157,TP,0,12500,14472,973028,0.0,0.0,14472,12500
LapChol Case 0007 02,431,TP,6708,6692,86,986514,0.4974047160017796,0.6643557492324453,6794,13400
LapChol Case 0007 02,740,TN,1739,35845,10231,952185,0.03636934016522012,0.0701860596520967,11970,37584
LapChol Case 0007 02,1310,TP,0,79109,6642,914249,0.0,0.0,6642,79109
LapChol Case 0007 02,1459,TP,8118,2692,3109,986081,0.5832315539909476,0.7367609021191632,11227,10810
LapChol Case 0007 02,1585,TP,3575,5800,455,990170,0.36368260427263477,0.5333830660201417,4030,9375
LapChol Case 0007 02,1662,TP,6996,4830,2332,985842,0.4941375900550925,0.6614351895622578,9328,11826
LapChol Case 0007 02,1716,TN,7000,5702,2000,985298,0.4761256971840566,0.6451018339323564,9000,12702
LapChol Case 0007 02,1725,TP,7592,5850,2392,984166,0.4794745484400657,0.6481687014428413,9984,13442
LapChol Case 0007 02,1775,TN,6375,2175,680,990770,0.69068255687974,0.8170458186478693,7055,8550
LapChol Case 0007 02,1791,TP,5525,6301,1020,987154,0.43009497119725987,0.6014914811387513,6545,11826
LapChol Case 0007 02,1868,TP,3640,3329,2443,990588,0.3867403314917127,0.5577689243027888,6083,6969
LapChol Case 0007 02,1965,TP,5994,4941,567,988498,0.5211267605633803,0.6851851851851852,6561,10935
LapChol Case 0007 02,2049,TN,7224,5560,0,987216,0.565081351689612,0.7221111555377849,7224,12784
LapChol Case 0007 02,2070,TP,7500,975,2200,989325,0.702576112412178,0.8253094910591472,9700,8475
LapChol Case 0007 02,2128,TP,4984,6896,0,988120,0.41952861952861953,0.5910815939278937,4984,11880
LapChol Case 0007 02,2284,TP,6636,1636,158,991570,0.7871886120996441,0.8809239346873755,6794,8272
LapChol Case 0007 02,2568,TN,0,130854,13221,855925,0.0,0.0,13221,130854
LapChol Case 0007 02,2762,TP,8372,70603,637,920388,0.10516002612671456,0.19030732860520094,9009,78975
LapChol Case 0007 02,2905,TP,5917,488,4329,989266,0.5512390534749394,0.7107080655816468,10246,6405
LapChol Case 0007 02,3269,TP,0,32398,9804,957798,0.0,0.0,9804,32398
LapChol Case 0007 02,3926,TP,9102,66148,2220,922530,0.11749064153866012,0.2102758397634339,11322,75250
LapChol Case 0007 02,4477,TP,0,28050,26553,945397,0.0,0.0,26553,28050
LapChol Case 0007 02,5129,TP,10816,6558,0,982626,0.622539426729596,0.7673643135863781,10816,17374
LapChol Case 0007 02,5418,TN,0,31641,9900,958459,0.0,0.0,9900,31641
LapChol Case 0007 02,5575,TP,5780,5372,1530,987318,0.45576407506702415,0.6261510128913443,7310,11152
LapChol Case 0007 02,5732,TN,6560,2674,2848,987918,0.5429564641615626,0.7037871473017917,9408,9234
LapChol Case 0007 02,5751,TP,7062,873,2794,989271,0.6582160499580576,0.7938845483671519,9856,7935
LapChol Case 0007 02,6147,TP,8455,7785,0,983760,0.520628078817734,0.6847539987851792,8455,16240
LapChol Case 0007 02,6522,TP,11628,6622,912,980838,0.6068260098110845,0.7553101656381942,12540,18250
LapChol Case 0007 02,6637,TN,0,17969,12870,969161,0.0,0.0,12870,17969
LapChol Case 0007 02,7317,TN,0,31070,11960,956970,0.0,0.0,11960,31070
LapChol Case 0007 02,7338,TP,0,26208,15525,958267,0.0,0.0,15525,26208
LapChol Case 0007 02,7929,TP,21840,5088,3120,969952,0.7268370607028753,0.8418131359851989,24960,26928
LapChol Case 0007 02,8710,TP,14490,22113,920,962477,0.3861631532659969,0.5571684002076404,15410,36603
LapChol Case 0007 02,8744,TN,0,17472,13673,968855,0.0,0.0,13673,17472
LapChol Case 0007 02,8952,TP,7360,4298,184,988158,0.6215166357034285,0.7665868138735549,7544,11658
LapChol Case 0007 03,259,TN,5146,13654,2656,978544,0.23983967188665176,0.386888203894444,7802,18800
LapChol Case 0007 03,265,TP,0,18700,6732,974568,0.0,0.0,6732,18700
LapChol Case 0007 03,295,TN,3600,13100,40080,943220,0.06340260655160268,0.11924478304074197,43680,16700
LapChol Case 0007 03,1117,TP,7830,3170,4475,984525,0.5059773828756058,0.671958807122935,12305,11000
LapChol Case 0007 03,1487,TP,10250,0,8434,981316,0.5485977306786556,0.7085090205294808,18684,10250
LapChol Case 0007 03,1669,TP,6177,2871,4639,986313,0.45130415722948786,0.6219291180024165,10816,9048
LapChol Case 0007 03,2114,TP,5180,3244,976,990600,0.551063829787234,0.710562414266118,6156,8424
LapChol Case 0007 03,2456,TP,9840,1035,4674,984451,0.6328381246382404,0.7751388396549687,14514,10875
LapChol Case 0007 03,2507,TP,8084,2444,6958,982514,0.4623127073087041,0.6323034806413766,15042,10528
LapChol Case 0007 03,2630,TP,7128,2187,6088,984597,0.46276699344283584,0.6327282410900537,13216,9315
LapChol Case 0007 03,2745,TP,7134,2784,7386,982696,0.4122746185852982,0.5838448318192978,14520,9918
LapChol Case 0007 03,3445,TP,7738,4817,11414,976031,0.3228336601443531,0.4880941117103479,19152,12555
LapChol Case 0007 03,3628,TP,9180,6296,0,984524,0.5931765314034634,0.744646333549643,9180,15476
LapChol Case 0007 03,3759,TP,13287,8590,5031,973092,0.4937936673108369,0.6611270058464983,18318,21877
LapChol Case 0007 03,4201,TP,27027,15093,0,957880,0.6416666666666667,0.7817258883248731,27027,42120
LapChol Case 0007 03,4519,TP,15232,952,13426,970390,0.5144208037825059,0.679363097096472,28658,16184
LapChol Case 0007 03,4738,TP,14763,2112,1463,981662,0.805049623732141,0.8919972206277756,16226,16875
LapChol Case 0007 03,4859,TP,12462,1116,12240,974182,0.482686497792238,0.6510971786833856,24702,13578
LapChol Case 0007 03,5500,TP,15965,1550,14035,968450,0.5060221870047543,0.6719983163211617,30000,17515
LapChol Case 0007 03,6093,TP,14600,0,14275,971125,0.5056277056277056,0.6716503737780334,28875,14600
LapChol Case 0007 03,6981,TP,11663,5337,7657,975343,0.4730096929877925,0.6422356828193833,19320,17000
LapChol Case 0007 03,7153,TN,0,26732,53040,920228,0.0,0.0,53040,26732
LapChol Case 0007 03,7180,TP,11235,6712,4641,977412,0.4973879936249336,0.6643408331608669,15876,17947
LapChol Case 0007 03,7559,TP,13536,188,10171,976105,0.5664783427495292,0.7232507814378456,23707,13724
LapChol Case 0007 03,7761,TP,0,25116,23691,951193,0.0,0.0,23691,25116
LapChol Case 0007 03,8050,TP,9639,3661,3689,983011,0.5673671199011124,0.7239747634069401,13328,13300
LapChol Case 0007 03,8148,TP,13888,112,5944,980056,0.6963497793822704,0.8209978718373138,19832,14000
LapChol Case 0007 03,8264,TP,8800,2010,4720,984470,0.5666452028332261,0.7233867653103164,13520,10810
LapChol Case 0007 03,8359,TP,9500,25786,7920,956794,0.2198768689533861,0.3604902667627974,17420,35286
LapChol Case 0007 03,8720,TP,15200,39496,14560,930744,0.21947556890377729,0.35995074358245716,29760,54696
LapChol Case 0007 03,8884,TP,6675,1950,7605,983770,0.411275415896488,0.5828421741977734,14280,8625
LapChol Case 0007 03,8944,TP,17584,8816,785,972815,0.6468272944638588,0.7855435680939936,18369,26400
LapChol Case 0007 03,9451,TP,8554,20134,9524,961788,0.22385638019470325,0.3658213231835094,18078,28688
LapChol Case 0007 03,9635,TP,2782,35824,27010,934384,0.04239819556205803,0.08134740781894208,29792,38606
LapChol Case 0007 03,9764,TP,10465,3235,2990,983310,0.6270221689634512,0.7707604492726938,13455,13700
LapChol Case 0007 03,9950,TP,9918,2784,2850,984448,0.6377314814814815,0.7787985865724382,12768,12702
LapChol Case 0012 03,0,TP,6386,744,6934,985936,0.45406712172923774,0.6245476772616136,13320,7130
LapChol Case 0012 03,128,TP,7938,0,7406,984656,0.5173357664233577,0.6819001803968732,15344,7938
LapChol Case 0012 03,207,TP,7102,2972,2332,987594,0.5724649363211349,0.7281115439819561,9434,10074
LapChol Case 0012 03,431,TP,0,12382,23114,964504,0.0,0.0,23114,12382
LapChol Case 0012 03,570,TN,22984,2772,36089,938155,0.37163877435524295,0.5418901554892784,59073,25756
LapChol Case 0012 03,595,TP,0,37412,13520,949068,0.0,0.0,13520,37412
LapChol Case 0012 03,620,TP,0,30888,40470,928642,0.0,0.0,40470,30888
LapChol Case 0012 03,1010,TP,9048,0,4152,986800,0.6854545454545454,0.8133764832793959,13200,9048
LapChol Case 0012 03,1400,TP,0,76140,20868,902992,0.0,0.0,20868,76140
LapChol Case 0012 03,1433,TN,0,80128,16383,903489,0.0,0.0,16383,80128
LapChol Case 0012 03,1878,TP,0,42818,27768,929414,0.0,0.0,27768,42818
LapChol Case 0012 03,1995,TP,0,32700,14375,952925,0.0,0.0,14375,32700
LapChol Case 0012 03,2155,TP,0,19588,15049,965363,0.0,0.0,15049,19588
LapChol Case 0012 03,2218,TP,0,24497,14375,961128,0.0,0.0,14375,24497
LapChol Case 0012 03,2337,TP,0,22372,15428,962200,0.0,0.0,15428,22372
LapChol Case 0012 03,2532,TP,0,22253,15232,962515,0.0,0.0,15232,22253
LapChol Case 0012 03,2732,TP,0,18871,9072,972057,0.0,0.0,9072,18871
LapChol Case 0012 03,2823,TP,0,18758,13530,967712,0.0,0.0,13530,18758
LapChol Case 0012 03,2940,TP,18271,24272,242,957215,0.42704218768259905,0.5984997379454927,18513,42543
LapChol Case 0012 03,3778,TP,7875,10180,5697,976248,0.3315510272819131,0.49799222183577324,13572,18055
LapChol Case 0012 03,3904,TP,9317,1015,9871,979797,0.46116913329703507,0.6312330623306233,19188,10332
LapChol Case 0012 03,4051,TP,53165,30451,6510,909874,0.589896367307991,0.7420563747897635,59675,83616
LapChol Case 0012 03,4333,TP,6622,3410,2388,987580,0.5331723027375201,0.6955151769772083,9010,10032
LapChol Case 0012 03,4682,TP,0,19900,14170,965930,0.0,0.0,14170,19900
LapChol Case 0012 03,4938,TN,0,18656,13068,968276,0.0,0.0,13068,18656
LapChol Case 0012 03,5062,TN,0,27250,22308,950442,0.0,0.0,22308,27250
LapChol Case 0012 03,5150,TP,28028,54472,3861,913639,0.32454464399439564,0.4900471199153765,31889,82500
LapChol Case 0012 03,5271,TP,0,39300,19564,941136,0.0,0.0,19564,39300
LapChol Case 0012 03,5657,TP,0,15604,25280,959116,0.0,0.0,25280,15604
LapChol Case 0012 03,5875,TP,11766,10608,42450,935176,0.1815068493150685,0.3072463768115942,54216,22374
LapChol Case 0012 03,6138,TP,5104,23300,4196,967400,0.1565644171779141,0.2707405049862084,9300,28404
LapChol Case 0012 03,7223,TP,8829,405,12906,977860,0.39878048780487807,0.5701830863121186,21735,9234
LapChol Case 0012 03,7730,TP,6525,450,10505,982520,0.3732837528604119,0.5436367423453448,17030,6975
LapChol Case 0012 03,8338,TP,10125,32976,13425,943474,0.17912111240844922,0.3038213980285367,23550,43101
LapChol Case 0012 03,8432,TN,0,28908,11865,959227,0.0,0.0,11865,28908
LapChol Case 0012 03,8462,TP,0,42276,11990,945734,0.0,0.0,11990,42276
LapChol Case 0012 03,8727,TP,34933,21539,16984,926544,0.4755636027009366,0.6445857051914862,51917,56472
LapChol Case 0012 03,8803,TP,7797,1587,15207,975409,0.3170672197145297,0.4814746202297147,23004,9384
LapChol Case 0012 03,9056,TP,6935,23215,5917,963933,0.1922810325228048,0.32254313752848707,12852,30150
LapChol Case 0012 03,9612,TN,0,21131,31706,947163,0.0,0.0,31706,21131
LapChol Case 0012 03,9960,TN,3520,5030,44150,947300,0.0667931688804554,0.12522234080398434,47670,8550
LapChol Case 0012 04,0,TP,9234,0,57883,932883,0.13758064275816856,0.2418828830008775,67117,9234
LapChol Case 0012 04,44,TN,0,56400,17160,926440,0.0,0.0,17160,56400
LapChol Case 0012 04,47,TN,14608,7862,7802,969728,0.48255813953488375,0.6509803921568628,22410,22470
LapChol Case 0012 04,502,TP,9234,57102,7470,926194,0.1251117795301195,0.22239884393063583,16704,66336
LapChol Case 0012 04,764,TP,0,14600,82656,902744,0.0,0.0,82656,14600
LapChol Case 0012 04,1217,TP,0,32700,47775,919525,0.0,0.0,47775,32700
LapChol Case 0012 04,1243,TN,0,14601,11440,973959,0.0,0.0,11440,14601
LapChol Case 0012 04,1273,TP,0,14600,19043,966357,0.0,0.0,19043,14600
LapChol Case 0012 04,1384,TN,0,28034,18864,953102,0.0,0.0,18864,28034
LapChol Case 0012 04,1674,TP,6510,1240,8730,983520,0.3950242718446602,0.5663331883427577,15240,7750
LapChol Case 0012 04,3653,TP,11300,1200,8734,978766,0.5321653951210323,0.6946578963545829,20034,12500
LapChol Case 0012 04,4037,TP,7350,4476,2352,985822,0.5184088023698689,0.6828316610925307,9702,11826
LapChol Case 0012 04,4290,TP,124,15352,68726,915798,0.0014726491057219543,0.002940967198728743,68850,15476
LapChol Case 0012 04,4833,TN,0,40464,39919,919617,0.0,0.0,39919,40464
LapChol Case 0012 04,5602,TP,40725,6449,4275,948551,0.791560574549554,0.8836548267407295,45000,47174
LapChol Case 0012 04,5666,TN,14934,9694,10392,964980,0.4264420331239292,0.5979100772710894,25326,24628
LapChol Case 0012 04,6209,TP,0,20875,17812,961313,0.0,0.0,17812,20875
LapChol Case 0012 04,6398,TP,1764,18971,64269,914996,0.020751964613429957,0.04066015120781855,66033,20735
LapChol Case 0012 04,6518,TP,0,10000,56334,933666,0.0,0.0,56334,10000
LapChol Case 0012 04,6967,TP,44492,107978,4767,842763,0.282961389494839,0.4411066331563632,49259,152470
LapChol Case 0012 04,7154,TP,73660,39878,5510,880952,0.6187420200255359,0.7644726736824626,79170,113538
LapChol Case 0012 04,7739,TP,40261,19523,16439,923777,0.5282001495611561,0.691270904158511,56700,59784
LapChol Case 0012 04,8108,TN,0,41600,33660,924740,0.0,0.0,33660,41600
LapChol Case 0012 04,8119,TP,0,36036,4810,959154,0.0,0.0,4810,36036
LapChol Case 0012 04,8272,TP,3614,16314,34992,945080,0.06580480699198835,0.12348378720060137,38606,19928
LapChol Case 0012 04,9014,TN,10340,20758,3812,965090,0.2961902033801203,0.4570165745856354,14152,31098
LapChol Case 0012 04,9043,TP,10810,940,5980,982270,0.6097010716300056,0.7575332866152769,16790,11750
LapChol Case 0012 04,9473,TP,9300,3999,5932,980769,0.48359419686963756,0.6519224702954681,15232,13299
LapChol Case 0012 04,9909,TP,0,29550,12462,957988,0.0,0.0,12462,29550
LapChol Case 0016 01,2711,TN,0,12500,19886,967614,0.0,0.0,19886,12500
LapChol Case 0016 01,3252,TP,0,5928,15184,978888,0.0,0.0,15184,5928
LapChol Case 0016 01,3481,TP,208,5616,29933,964243,0.005817042816791118,0.011566801056582789,30141,5824
LapChol Case 0016 01,3493,TP,8733,1542,2214,987511,0.6992553447033389,0.8230138535482047,10947,10275
LapChol Case 0016 01,3582,TP,0,15600,14986,969414,0.0,0.0,14986,15600
LapChol Case 0016 01,3702,TP,9375,15136,9945,965544,0.2720861388437427,0.42777942552075016,19320,24511
LapChol Case 0016 01,3969,TP,8906,219,15261,975614,0.3652095464610842,0.5350234290520245,24167,9125
LapChol Case 0016 01,4082,TP,6141,1035,5563,987261,0.4820629562760028,0.6505296610169492,11704,7176
LapChol Case 0016 01,4204,TP,7050,825,18922,973203,0.2630891517707206,0.4165804945785446,25972,7875
LapChol Case 0016 01,4304,TP,8137,2113,2955,986795,0.6162059825823551,0.7625339705744542,11092,10250
LapChol Case 0016 01,4433,TP,9375,0,17211,973414,0.35262920334010384,0.5213981813631434,26586,9375
LapChol Case 0016 01,4551,TP,6561,1134,6623,985682,0.4582343902779718,0.6284783754011207,13184,7695
LapChol Case 0016 01,4669,TP,9315,81,19485,971119,0.32253038329697725,0.4877474081055608,28800,9396
LapChol Case 0016 01,4768,TP,6392,0,13616,979992,0.3194722111155538,0.48424242424242425,20008,6392
LapChol Case 0016 01,4882,TP,7728,207,12022,980043,0.3872325499824623,0.5582806573957017,19750,7935
LapChol Case 0016 01,4973,TP,5795,0,15765,978440,0.2687847866419295,0.42368853957229025,21560,5795
LapChol Case 0016 01,5061,TP,6975,0,14973,978052,0.3177966101694915,0.48231511254019294,21948,6975
LapChol Case 0016 01,5192,TP,23864,5150,12211,958775,0.578872043662826,0.7332729032555424,36075,29014
LapChol Case 0016 01,5302,TP,10125,23500,16993,949382,0.2000276581453238,0.33337174653869583,27118,33625
LapChol Case 0016 01,5354,TP,5358,20944,16055,957643,0.12649621077980028,0.2245834643193964,21413,26302
LapChol Case 0016 01,5508,TP,8625,19588,19743,952044,0.17985236466761198,0.30487266043371447,28368,28213
LapChol Case 0016 01,5675,TP,6615,31147,16413,945825,0.12210429164743886,0.2176344793551571,23028,37762
LapChol Case 0016 01,5747,TP,8424,23187,23636,944753,0.15247886763082158,0.26461026212875566,32060,31611
LapChol Case 0016 01,5903,TP,13600,21746,7048,957606,0.3208001132235694,0.4857663321070115,20648,35346
LapChol Case 0016 01,6019,TP,0,24249,28380,947371,0.0,0.0,28380,24249
LapChol Case 0016 01,6080,TP,0,23056,24150,952794,0.0,0.0,24150,23056
LapChol Case 0016 01,6164,TP,0,23375,21670,954955,0.0,0.0,21670,23375
LapChol Case 0016 01,6336,TP,0,17702,16480,965818,0.0,0.0,16480,17702
LapChol Case 0016 01,6424,TP,12848,31190,19270,936692,0.20294433562898845,0.3374126792373549,32118,44038
LapChol Case 0016 01,6756,TP,0,40391,42903,916706,0.0,0.0,42903,40391
LapChol Case 0016 01,6908,TP,0,34350,26586,939064,0.0,0.0,26586,34350
LapChol Case 0016 01,7019,TP,0,43940,18203,937857,0.0,0.0,18203,43940
LapChol Case 0016 01,7229,TP,16720,69208,5789,908283,0.18229990078175257,0.3083818253917021,22509,85928
LapChol Case 0016 01,7467,TP,0,42282,31610,926108,0.0,0.0,31610,42282
LapChol Case 0016 01,7546,TP,0,42380,24300,933320,0.0,0.0,24300,42380
LapChol Case 0016 01,7633,TP,12470,28965,28234,930331,0.1789892204567311,0.30363164879046495,40704,41435
LapChol Case 0016 01,7786,TP,0,40560,18870,940570,0.0,0.0,18870,40560
LapChol Case 0016 01,8076,TP,8550,0,14850,976600,0.36538461538461536,0.5352112676056338,23400,8550
LapChol Case 0016 01,8437,TP,0,42120,17835,940045,0.0,0.0,17835,42120
LapChol Case 0016 01,8642,TN,0,37728,18445,943827,0.0,0.0,18445,37728
LapChol Case 0016 01,8655,TP,7072,42404,10864,939660,0.11720251905866755,0.20981427638996025,17936,49476
LapChol Case 0016 01,8862,TP,14444,0,30946,954610,0.31821987221855036,0.4828024200287462,45390,14444
LapChol Case 0016 01,9196,TP,0,56454,20328,923218,0.0,0.0,20328,56454
LapChol Case 0016 01,9403,TP,19110,17759,2352,960779,0.4872389791183295,0.6552262090483619,21462,36869
LapChol Case 0016 01,9458,TP,0,29029,30396,940575,0.0,0.0,30396,29029
LapChol Case 0018 10,98,TP,8991,21009,22485,947515,0.17130608745355816,0.29250439195783723,31476,30000
LapChol Case 0018 10,635,TP,0,14696,17250,968054,0.0,0.0,17250,14696
LapChol Case 0018 10,1004,TP,0,24684,22165,953151,0.0,0.0,22165,24684
LapChol Case 0018 10,2276,TP,0,23496,15624,960880,0.0,0.0,15624,23496
LapChol Case 0018 10,2568,TP,0,94536,20306,885158,0.0,0.0,20306,94536
LapChol Case 0018 10,2620,TP,0,19873,14161,965966,0.0,0.0,14161,19873
LapChol Case 0018 10,2657,TP,0,19873,6804,973323,0.0,0.0,6804,19873
LapChol Case 0018 10,2835,TP,7050,25944,10222,956784,0.1631340244353943,0.28050769904110134,17272,32994
LapChol Case 0018 10,3069,TP,0,27300,9450,963250,0.0,0.0,9450,27300
LapChol Case 0018 10,3272,TP,0,28656,22780,948564,0.0,0.0,22780,28656
LapChol Case 0018 10,3527,TP,0,20750,17399,961851,0.0,0.0,17399,20750
LapChol Case 0018 10,3669,TP,0,55000,16848,928152,0.0,0.0,16848,55000
LapChol Case 0018 10,4470,TP,6643,1781,1183,990393,0.6914749661705006,0.8176,7826,8424
LapChol Case 0018 10,5109,TP,7743,348,11297,980612,0.3993707447905921,0.5707861855442115,19040,8091
LapChol Case 0018 10,6108,TP,5859,0,14565,979576,0.2868683901292597,0.4458395160369821,20424,5859
LapChol Case 0018 10,6362,TP,8424,0,7526,984050,0.5281504702194357,0.6912283580864856,15950,8424
LapChol Case 0018 10,6853,TP,6720,420,5775,987085,0.5203252032520326,0.6844919786096256,12495,7140
LapChol Case 0018 10,7403,TP,8360,0,24004,967636,0.2583117043628723,0.41056870641390825,32364,8360
LapChol Case 0018 10,7720,TN,15132,2570,44196,938102,0.24446670328605125,0.3928858886148254,59328,17702
LapChol Case 0018 10,7736,TP,10164,2538,35191,952107,0.2122230806172092,0.35013865683724615,45355,12702
LapChol Case 0018 10,7989,TP,14872,3573,1430,980125,0.7482767295597484,0.85601634673497,16302,18445
LapChol Case 0018 10,8300,TP,6750,150,5050,988050,0.5648535564853556,0.7219251336898396,11800,6900
LapChol Case 0018 10,8454,TP,6510,465,8382,984643,0.4239109201015823,0.5954177527781589,14892,6975
LapChol Case 0018 10,9683,TN,0,11625,21060,967315,0.0,0.0,21060,11625
LapChol Case 0018 10,9705,TP,341,13259,11215,975185,0.013741688494861978,0.0271108284305931,11556,13600
LapChol Case 0018 10,9743,TN,0,12200,22010,965790,0.0,0.0,22010,12200
LapChol Case 0018 10,9858,TP,0,52750,21375,925875,0.0,0.0,21375,52750
LapChol Case 0018 11,0,TP,16284,33867,13886,935963,0.25429048831144496,0.40547303942928997,30170,50151
LapChol Case 0018 11,54,TP,0,53775,19588,926637,0.0,0.0,19588,53775
LapChol Case 0018 11,289,TN,0,54750,11210,934040,0.0,0.0,11210,54750
LapChol Case 0018 11,1297,TP,6237,945,5515,987303,0.4912183980467827,0.658814830463716,11752,7182
LapChol Case 0018 11,2966,TP,14880,8438,9648,967034,0.45137414305648244,0.6219955691175856,24528,23318
LapChol Case 0018 11,3067,TP,0,60926,13530,925544,0.0,0.0,13530,60926
LapChol Case 0018 11,3260,TP,9430,0,17462,973108,0.3506619068868065,0.5192445349925665,26892,9430
LapChol Case 0018 11,3885,TP,0,32111,14742,953147,0.0,0.0,14742,32111
LapChol Case 0018 11,4269,TP,8424,0,21452,970124,0.28196545722318916,0.43989556135770236,29876,8424
LapChol Case 0018 11,6528,TP,15600,0,13759,970641,0.5313532477264212,0.6939656131141707,29359,15600
LapChol Case 0018 11,6639,TP,8000,3000,6560,982440,0.45558086560364464,0.6259780907668232,14560,11000
LapChol Case 0018 11,7590,TP,7626,124,10186,982064,0.42517841213202495,0.596666927470464,17812,7750
LapChol Case 0018 11,7951,TP,7072,0,20648,972280,0.25512265512265514,0.40653023683605427,27720,7072
LapChol Case 0018 11,8139,TP,7176,0,10368,982456,0.40902872777017785,0.5805825242718446,17544,7176
LapChol Case 0018 11,8971,TN,0,68564,65320,866116,0.0,0.0,65320,68564
LapChol Case 0018 11,9361,TP,10200,0,27152,962648,0.2730777468408653,0.42900403768506057,37352,10200
LapChol Case 0018 11,10023,TP,0,6552,34304,959144,0.0,0.0,34304,6552
LapChol Case 0019 02,1423,TP,0,28625,15589,955786,0.0,0.0,15589,28625
LapChol Case 0019 02,1790,TP,0,40404,35208,924388,0.0,0.0,35208,40404
LapChol Case 0019 02,2077,TP,30080,6794,14002,949124,0.5912414497995125,0.743119719353723,44082,36874
LapChol Case 0019 02,3556,TP,8505,0,32319,959176,0.20833333333333334,0.3448275862068966,40824,8505
LapChol Case 0019 02,4039,TP,0,13731,15264,971005,0.0,0.0,15264,13731
LapChol Case 0019 02,5707,TP,15625,0,13259,971116,0.5409569311729677,0.7021051922083175,28884,15625
LapChol Case 0019 02,7032,TP,0,28032,52710,919258,0.0,0.0,52710,28032
LapChol Case 0019 03,0,TP,11750,0,27429,960821,0.2999055616529263,0.4614266920614974,39179,11750
LapChol Case 0019 03,2388,TP,16837,791,26963,955409,0.37758740553026393,0.5481864947580908,43800,17628
LapChol Case 0019 03,2607,TP,0,27250,35148,937602,0.0,0.0,35148,27250
LapChol Case 0019 03,5871,TP,0,23500,20925,955575,0.0,0.0,20925,23500
LapChol Case 0019 03,6735,TP,0,42340,29559,928101,0.0,0.0,29559,42340
LapChol Case 0019 03,6952,TP,9657,25807,17898,946638,0.18097147783066603,0.30647899839730874,27555,35464
LapChol Case 0019 03,7156,TN,1750,20250,44678,933322,0.026245538258496057,0.05114865259835155,46428,22000
LapChol Case 0019 03,7409,TP,8424,51120,35410,905046,0.08871664174231733,0.16297471415581652,43834,59544
LapChol Case 0019 03,7612,TP,0,50440,27555,922005,0.0,0.0,27555,50440
LapChol Case 0019 03,7785,TP,7752,51864,14440,925944,0.1046775413200821,0.18951691766086445,22192,59616
LapChol Case 0019 03,7884,TP,0,55750,13923,930327,0.0,0.0,13923,55750
LapChol Case 0019 03,8398,TP,0,82992,26243,890765,0.0,0.0,26243,82992
LapChol Case 0019 03,8506,TP,8004,83398,14036,894562,0.07591191031696352,0.1411117575501137,22040,91402
LapChol Case 0019 03,9590,TP,0,127602,30912,841486,0.0,0.0,30912,127602
LapChol Case 0020 02,4055,TP,0,11523,8833,979644,0.0,0.0,8833,11523
LapChol Case 0020 02,4429,TP,7245,2875,5819,984061,0.45454545454545453,0.625,13064,10120
LapChol Case 0020 02,4913,TP,0,11826,21710,966464,0.0,0.0,21710,11826
LapChol Case 0020 02,5081,TN,0,15700,6348,977952,0.0,0.0,6348,15700
LapChol Case 0020 02,5103,TP,0,10004,5740,984256,0.0,0.0,5740,10004
LapChol Case 0020 02,5344,TP,5002,4382,2214,988402,0.43128125538886014,0.6026506024096385,7216,9384
LapChol Case 0020 02,5521,TP,0,12848,11280,975872,0.0,0.0,11280,12848
LapChol Case 0020 02,5748,TN,0,19822,7384,972794,0.0,0.0,7384,19822
LapChol Case 0020 02,5862,TP,0,17600,13900,968500,0.0,0.0,13900,17600
LapChol Case 0020 02,6323,TP,9000,2625,3460,984915,0.596619158104077,0.747353124351256,12460,11625
LapChol Case 0020 02,6642,TN,0,11826,7488,980686,0.0,0.0,7488,11826
LapChol Case 0020 02,6792,TN,0,9648,4848,985504,0.0,0.0,4848,9648
LapChol Case 0020 02,6826,TP,5440,5560,4794,984206,0.34443459541598076,0.5123857963643214,10234,11000
LapChol Case 0020 02,6995,TP,5304,1144,5361,988191,0.44914895418748413,0.6198796236779057,10665,6448
LapChol Case 0020 02,7139,TP,9660,1215,2025,987100,0.7488372093023256,0.8563829787234043,11685,10875
LapChol Case 0020 02,7283,TP,7935,0,12317,979748,0.39181315425636976,0.563025508213006,20252,7935
LapChol Case 0020 02,7407,TP,8944,832,7733,982491,0.5108230053115541,0.6762181983139909,16677,9776
LapChol Case 0020 02,7495,TP,8424,0,25853,965723,0.24576246462642587,0.39455750450809113,34277,8424
LapChol Case 0020 02,7679,TP,0,10074,22176,967750,0.0,0.0,22176,10074
LapChol Case 0020 02,7819,TP,6956,12619,3964,976461,0.2955095798462127,0.45620593539924575,10920,19575
LapChol Case 0020 02,7920,TP,0,11454,5115,983431,0.0,0.0,5115,11454
LapChol Case 0020 02,8056,TP,8505,12504,1260,977731,0.38192105617674793,0.5527393254045623,9765,21009
LapChol Case 0020 02,8201,TP,5928,10833,7077,976162,0.2486785804178203,0.3983067929852852,13005,16761
LapChol Case 0020 02,8638,TP,0,12636,14304,973060,0.0,0.0,14304,12636
LapChol Case 0020 02,8763,TP,0,12702,17160,970138,0.0,0.0,17160,12702
LapChol Case 0020 02,8889,TP,8343,20784,7110,963763,0.23023429091812236,0.37429340511440107,15453,29127
LapChol Case 0020 02,9100,TP,7437,14094,5121,973348,0.2790409725348942,0.436328434392326,12558,21531
LapChol Case 0020 02,9231,TN,0,13659,13818,972523,0.0,0.0,13818,13659
LapChol Case 0020 02,9272,TP,7575,14442,7358,970625,0.2578723404255319,0.4100135317997294,14933,22017
LapChol Case 0020 02,9382,TP,0,15486,9296,975218,0.0,0.0,9296,15486
LapChol Case 0020 02,9507,TP,7684,0,2612,989704,0.7463092463092463,0.8547274749721914,10296,7684
LapChol Case 0020 02,9794,TP,7800,14529,15717,961954,0.2050149818640593,0.34026959822012826,23517,22329
LapChol Case 0020 03,0,TP,26200,0,41938,931862,0.3845137808564971,0.5554495537323242,68138,26200
LapChol Case 0020 03,64,TP,0,14529,22743,962728,0.0,0.0,22743,14529
LapChol Case 0020 03,312,TN,0,14758,10791,974451,0.0,0.0,10791,14758
LapChol Case 0020 03,343,TP,10125,13659,53445,922771,0.1311036009789069,0.23181537193488563,63570,23784
LapChol Case 0020 03,620,TN,0,16554,9576,973870,0.0,0.0,9576,16554
LapChol Case 0020 03,652,TP,0,16638,30024,953338,0.0,0.0,30024,16638
LapChol Case 0020 03,685,TN,0,14696,15984,969320,0.0,0.0,15984,14696
LapChol Case 0020 03,714,TP,10810,16700,8414,964076,0.3009130386371228,0.46261822227928273,19224,27510
LapChol Case 0020 03,800,TN,5922,14529,13090,966459,0.17656003100682746,0.30012923497960114,19012,20451
LapChol Case 0020 03,965,TP,0,14432,12078,973490,0.0,0.0,12078,14432
LapChol Case 0020 03,1317,TN,0,13816,15228,970956,0.0,0.0,15228,13816
LapChol Case 0020 03,1358,TP,0,13527,25976,960497,0.0,0.0,25976,13527
LapChol Case 0020 03,1772,TN,0,10125,17928,971947,0.0,0.0,17928,10125
LapChol Case 0020 03,1794,TP,0,12636,14949,972415,0.0,0.0,14949,12636
LapChol Case 0020 03,1868,TN,0,12717,22156,965127,0.0,0.0,22156,12717
LapChol Case 0020 03,1892,TP,7800,13074,11730,967396,0.23923444976076555,0.3861003861003861,19530,20874
LapChol Case 0020 03,2036,TN,0,14608,23760,961632,0.0,0.0,23760,14608
LapChol Case 0020 03,2424,TP,0,12555,15656,971789,0.0,0.0,15656,12555
LapChol Case 0020 03,2581,TN,0,19700,15184,965116,0.0,0.0,15184,19700
LapChol Case 0020 03,2625,TP,11070,0,12910,976020,0.4616346955796497,0.6316690442225392,23980,11070
LapChol Case 0020 03,2884,TP,0,19552,51507,928941,0.0,0.0,51507,19552
LapChol Case 0020 03,3068,TP,14162,15750,29881,940207,0.23685046744602212,0.38298965587181394,44043,29912
LapChol Case 0020 03,3334,TP,0,16732,74259,909009,0.0,0.0,74259,16732
LapChol Case 0020 03,3575,TP,11934,31400,2999,953667,0.2575701983467507,0.4096315238471176,14933,43334
LapChol Case 0020 03,3749,TN,0,14664,38710,946626,0.0,0.0,38710,14664
LapChol Case 0020 03,4264,TP,0,12717,24897,962386,0.0,0.0,24897,12717
LapChol Case 0020 03,4891,TN,0,13572,31824,954604,0.0,0.0,31824,13572
LapChol Case 0020 03,4947,TN,0,13442,18997,967561,0.0,0.0,18997,13442
LapChol Case 0020 03,4989,TP,0,13485,21960,964555,0.0,0.0,21960,13485
LapChol Case 0020 03,5024,TN,0,13728,10611,975661,0.0,0.0,10611,13728
LapChol Case 0020 03,5429,TP,14500,22900,13722,948878,0.2836352255389069,0.4419249641888391,28222,37400
LapChol Case 0020 03,5705,TP,15700,13098,28652,942550,0.2732811140121845,0.42925495557074506,44352,28798
LapChol Case 0020 03,5865,TP,11016,14476,22576,951932,0.22917533494216527,0.3728928305463408,33592,25492
LapChol Case 0020 03,6215,TP,0,37875,38801,923324,0.0,0.0,38801,37875
LapChol Case 0020 03,6373,TP,10368,39477,1458,948697,0.20209344482778785,0.3362358320766649,11826,49845
LapChol Case 0020 03,6524,TP,11152,2572,8682,977594,0.4977238239757208,0.6646403242147924,19834,13724
LapChol Case 0020 03,6932,TP,12956,14950,1230,970864,0.4446732564524986,0.6156039152332985,14186,27906
LapChol Case 0020 03,7118,TN,16700,0,30864,952436,0.3511058783954251,0.5197311091746546,47564,16700
LapChol Case 0020 03,7212,TP,17900,3000,14138,964962,0.5108739083281009,0.6762627979901016,32038,20900
LapChol Case 0020 03,7292,TP,0,15698,27738,956564,0.0,0.0,27738,15698
LapChol Case 0020 03,7616,TP,0,39562,23125,937313,0.0,0.0,23125,39562
LapChol Case 0020 03,7738,TP,6448,0,23252,970300,0.2171043771043771,0.3567555604736085,29700,6448
LapChol Case 0020 03,7852,TP,6789,16291,3379,973541,0.2565856608337428,0.4083854667949952,10168,23080
LapChol Case 0020 03,8046,TN,8308,992,20456,970244,0.27920419411211184,0.43652795292139557,28764,9300
LapChol Case 0020 03,8153,TP,16954,14296,11990,956760,0.3920906567992599,0.5633119580024587,28944,31250
LapChol Case 0020 03,8487,TP,21255,31473,745,946527,0.3974903222186898,0.568863076758377,22000,52728
LapChol Case 0020 03,8619,TP,13167,18142,4833,963858,0.3643129876597864,0.534060719138494,18000,31309
LapChol Case 0020 03,8712,TP,17940,40335,4500,937225,0.2857825567502987,0.4445270395837205,22440,58275
LapChol Case 0020 03,8813,TP,10268,27424,5027,957281,0.2403614316814532,0.38756676165852,15295,37692
LapChol Case 0020 03,8923,TP,4088,39533,7882,948497,0.07937401704755062,0.1470741666816571,11970,43621
LapChol Case 0020 03,9042,TP,5292,13350,20888,960470,0.1338730078421452,0.23613404131899512,26180,18642
LapChol Case 0020 03,9226,TP,13736,33430,22783,930051,0.19637164219645742,0.3282786640377606,36519,47166
LapChol Case 0020 03,9440,TN,0,32625,16422,950953,0.0,0.0,16422,32625
LapChol Case 0020 03,9464,TP,14500,20882,10590,954028,0.31540937962237886,0.47956078846408257,25090,35382
LapChol Case 0020 03,9634,TN,0,18700,20099,961201,0.0,0.0,20099,18700
LapChol Case 0020 03,9667,TP,10250,14696,33352,941702,0.17582078287419808,0.29906051234171677,43602,24946
LapChol Case 0020 03,9910,TN,0,15576,17388,967036,0.0,0.0,17388,15576
LapChol Case 0020 03,9944,TP,8000,21800,1867,968333,0.25262891969558215,0.4033579549751683,9867,29800
LapChol Case 0020 03,9986,TN,0,18800,17654,963546,0.0,0.0,17654,18800
LapChol Case 0020 03,10013,TP,0,17578,26460,955962,0.0,0.0,26460,17578
LapChol Case 0023 03,194,TP,5022,15154,10228,969596,0.16517563478489672,0.28352057810647546,15250,20176
LapChol Case 0023 03,330,TP,5880,5870,5997,982253,0.33132360398940663,0.49773564142718074,11877,11750
LapChol Case 0023 03,398,TP,0,14664,7802,977534,0.0,0.0,7802,14664
LapChol Case 0023 03,673,TP,4611,6389,522,988478,0.40019093907307757,0.5716233806483605,5133,11000
LapChol Case 0023 03,917,TP,9636,1270,7650,981444,0.5192929510670403,0.6835981838819524,17286,10906
LapChol Case 0023 03,917,TN,0,10906,11520,977574,0.0,0.0,11520,10906
LapChol Case 0023 03,1530,TP,0,24625,13250,962125,0.0,0.0,13250,24625
LapChol Case 0023 03,2066,TP,9831,4698,66115,919356,0.12190615544863846,0.21731970157502073,75946,14529
LapChol Case 0023 03,2390,TP,142,34979,10823,954056,0.003090719136339892,0.006162392049646313,10965,35121
LapChol Case 0023 03,2533,TP,3584,26541,11536,958339,0.08602769976716833,0.1584263454525362,15120,30125
LapChol Case 0023 03,2699,TP,0,26208,8480,965312,0.0,0.0,8480,26208
LapChol Case 0023 03,2964,TP,0,20944,8613,970443,0.0,0.0,8613,20944
LapChol Case 0023 03,3006,TP,0,16700,11040,972260,0.0,0.0,11040,16700
LapChol Case 0023 03,3083,TN,0,17578,26560,955862,0.0,0.0,26560,17578
LapChol Case 0023 03,3099,TP,0,18868,7410,973722,0.0,0.0,7410,18868
LapChol Case 0023 03,3258,TP,0,17700,18602,963698,0.0,0.0,18602,17700
LapChol Case 0023 03,3815,TP,0,15604,7696,976700,0.0,0.0,7696,15604
LapChol Case 0023 03,3994,TP,0,18700,13189,968111,0.0,0.0,13189,18700
LapChol Case 0023 03,4021,TN,0,10950,5336,983714,0.0,0.0,5336,10950
LapChol Case 0023 03,4039,TP,0,14508,6156,979336,0.0,0.0,6156,14508
LapChol Case 0023 03,5326,TP,5670,882,2202,991246,0.6477039067854695,0.7861896838602329,7872,6552
LapChol Case 0023 03,5456,TP,0,17296,6885,975819,0.0,0.0,6885,17296
LapChol Case 0023 03,5559,TP,0,12874,6000,981126,0.0,0.0,6000,12874
LapChol Case 0023 03,5637,TP,0,11968,6566,981466,0.0,0.0,6566,11968
LapChol Case 0023 03,5736,TP,0,13816,7470,978714,0.0,0.0,7470,13816
LapChol Case 0023 03,6027,TP,0,22908,6035,971057,0.0,0.0,6035,22908
LapChol Case 0023 03,6204,TP,0,19754,10742,969504,0.0,0.0,10742,19754
LapChol Case 0023 03,6624,TP,0,23500,4872,971628,0.0,0.0,4872,23500
LapChol Case 0023 03,6781,TP,0,22372,7918,969710,0.0,0.0,7918,22372
LapChol Case 0023 03,6890,TP,7630,30359,1417,960594,0.19362533624321168,0.32443234968959944,9047,37989
LapChol Case 0023 03,7061,TP,8280,25043,680,965997,0.2435079257712555,0.39164676110966584,8960,33323
LapChol Case 0023 03,7199,TP,7200,24568,300,967932,0.22452288886117,0.36671080778241827,7500,31768
LapChol Case 0023 03,7288,TN,2419,20295,4871,972415,0.08769258655066159,0.1612451673110252,7290,22714
LapChol Case 0023 03,7309,TP,7360,21236,1922,969482,0.24116914607772463,0.38861608321453084,9282,28596
LapChol Case 0023 03,7413,TN,0,14600,12546,972854,0.0,0.0,12546,14600
LapChol Case 0023 03,7755,TP,4134,19786,2509,973571,0.15641908509591737,0.2705231816248405,6643,23920
LapChol Case 0023 03,7869,TP,4740,15782,79,979399,0.23008591815931265,0.3740973126553806,4819,20522
LapChol Case 0023 03,7957,TP,6675,16300,3101,973924,0.25598251265531524,0.40762114133919575,9776,22975
LapChol Case 0023 03,8155,TP,4836,19939,248,974977,0.19326219877712505,0.323922435446599,5084,24775
LapChol Case 0023 03,8247,TP,6237,23121,0,970642,0.21244635193133046,0.3504424778761062,6237,29358
LapChol Case 0023 03,8359,TP,8580,18874,4986,967560,0.2644882860665845,0.4183325207215992,13566,27454
LapChol Case 0023 03,8487,TP,0,22176,15049,962775,0.0,0.0,15049,22176
LapChol Case 0023 03,8609,TP,7821,21235,1269,969675,0.25790601813685077,0.41005610024642164,9090,29056
LapChol Case 0023 03,8730,TP,0,24274,13653,962073,0.0,0.0,13653,24274
LapChol Case 0023 03,8848,TP,0,21131,10323,968546,0.0,0.0,10323,21131
LapChol Case 0023 03,8978,TP,0,21244,12154,966602,0.0,0.0,12154,21244
LapChol Case 0023 03,9105,TP,7209,23081,3603,966107,0.21269878736022188,0.3507858498369909,10812,30290
LapChol Case 0023 03,9258,TP,8475,900,759,989866,0.8362936648904677,0.9108495889085926,9234,9375
LapChol Case 0023 03,9373,TN,0,19873,7728,972399,0.0,0.0,7728,19873
LapChol Case 0023 03,9401,TP,0,16642,7957,975401,0.0,0.0,7957,16642
LapChol Case 0023 03,9518,TN,0,15476,13516,971008,0.0,0.0,13516,15476
LapChol Case 0023 03,9698,TN,0,13804,9545,976651,0.0,0.0,9545,13804
LapChol Case 0023 03,9803,TP,6960,25436,0,967604,0.21484133843684405,0.35369448114645796,6960,32396
LapChol Case 0023 03,9991,TP,0,39150,10212,950638,0.0,0.0,10212,39150
LapChol Case 0023 04,396,TN,0,37604,16166,946230,0.0,0.0,16166,37604
LapChol Case 0023 04,411,TP,24662,0,47386,927952,0.34229957805907174,0.5100196463654224,72048,24662
LapChol Case 0023 04,455,TP,11016,36018,7904,945062,0.20051694637591466,0.3340510052460806,18920,47034
LapChol Case 0023 04,666,TP,0,22176,38522,939302,0.0,0.0,38522,22176
LapChol Case 0023 04,890,TP,0,33875,9700,956425,0.0,0.0,9700,33875
LapChol Case 0023 04,988,TP,0,31059,17850,951091,0.0,0.0,17850,31059
LapChol Case 0023 04,1129,TP,0,35742,16854,947404,0.0,0.0,16854,35742
LapChol Case 0023 04,1257,TP,0,30798,18630,950572,0.0,0.0,18630,30798
LapChol Case 0023 04,1300,TP,5060,28631,13308,953001,0.10766186514606693,0.1943948212604929,18368,33691
LapChol Case 0023 04,1515,TP,6039,1143,2277,990541,0.6384395813510942,0.7793263646922184,8316,7182
LapChol Case 0023 04,1614,TP,0,18690,12320,968990,0.0,0.0,12320,18690
LapChol Case 0023 04,2061,TP,0,19296,9373,971331,0.0,0.0,9373,19296
LapChol Case 0023 04,2278,TN,0,30644,15207,954149,0.0,0.0,15207,30644
LapChol Case 0023 04,2676,TP,0,25944,14042,960014,0.0,0.0,14042,25944
LapChol Case 0023 04,2778,TP,0,23246,17255,959499,0.0,0.0,17255,23246
LapChol Case 0023 04,2880,TP,0,19375,14310,966315,0.0,0.0,14310,19375
LapChol Case 0023 04,2957,TP,0,16016,19182,964802,0.0,0.0,19182,16016
LapChol Case 0023 04,3040,TP,0,19519,16799,963682,0.0,0.0,16799,19519
LapChol Case 0023 04,3110,TP,0,10854,8925,980221,0.0,0.0,8925,10854
LapChol Case 0023 04,3376,TP,9375,25942,17337,947346,0.17804915106164773,0.3022779667574844,26712,35317
LapChol Case 0023 04,3443,TP,8625,32195,6571,952609,0.1819965816294233,0.3079477292202228,15196,40820
LapChol Case 0023 04,3576,TP,9300,24737,2883,963080,0.25189599133261104,0.4024231934227607,12183,34037
LapChol Case 0023 04,3750,TP,0,24625,13662,961713,0.0,0.0,13662,24625
LapChol Case 0023 04,4261,TP,9918,35850,24966,929266,0.14021545508524896,0.24594554381788425,34884,45768
LapChol Case 0023 04,4531,TP,0,31460,21760,946780,0.0,0.0,21760,31460
LapChol Case 0023 04,4676,TP,7800,21244,19315,951641,0.1612936578506586,0.2777827240513542,27115,29044
LapChol Case 0023 04,4929,TP,7866,21131,10152,960851,0.20092467240542541,0.33461661171966395,18018,28997
LapChol Case 0023 04,5527,TP,5824,23443,13376,957357,0.13657575686513612,0.24032847091835682,19200,29267
LapChol Case 0023 04,5783,TP,0,23443,12648,963909,0.0,0.0,12648,23443
LapChol Case 0023 04,6103,TP,0,16799,18392,964809,0.0,0.0,18392,16799
LapChol Case 0023 04,6347,TN,0,23500,9605,966895,0.0,0.0,9605,23500
LapChol Case 0023 04,6374,TP,0,24497,24186,951317,0.0,0.0,24186,24497
LapChol Case 0023 04,6526,TP,20178,3186,17392,959244,0.4950927470801845,0.6622903469327469,37570,23364
LapChol Case 0023 04,6598,TN,0,49051,26796,924153,0.0,0.0,26796,49051
LapChol Case 0023 04,7291,TP,0,28496,22925,948579,0.0,0.0,22925,28496
LapChol Case 0023 04,7567,TP,0,19873,21456,958671,0.0,0.0,21456,19873
LapChol Case 0023 04,7726,TN,0,19754,13578,966668,0.0,0.0,13578,19754
LapChol Case 0023 04,8359,TP,18816,23294,12838,945052,0.34243284559947584,0.510167561412071,31654,42110
LapChol Case 0023 04,9019,TP,9135,20332,18009,952524,0.19241300867806893,0.32272879829008494,27144,29467
LapChol Case 0023 04,9533,TP,12390,28084,7257,952269,0.2595797280593325,0.41216879293424924,19647,40474
LapChol Case 0023 04,9727,TP,7998,6100,1302,984600,0.5193506493506493,0.6836481750576973,9300,14098
